11 5 5 5 5 5 5 5 5 5 5 5 5 5 5 10
8 9 9 9 9 9 9 9 9 9 9 9 9 9 9 7
8 9 9 15 14 14 14 4 4 14 14 14 0 9 9 7
8 9 9 15 4 4 4 4 4 4 4 4 0 9 9 7
8 9 9 15 4 4 4 4 4 4 4 4 0 9 9 7
8 9 9 15 4 4 4 4 4 4 4 4 0 9 9 7
8 9 9 15 4 4 4 4 4 4 4 4 0 9 9 7
8 9 9 15 4 4 4 4 4 4 4 4 0 9 9 7
8 9 9 17 14 14 14 14 14 14 14 14 16 9 9 7
8 9 9 9 9 9 9 9 9 9 9 9 9 9 9 7
8 9 9 9 9 9 9 9 9 9 9 9 9 9 9 7
13 6 6 6 6 6 6 6 6 6 6 6 6 6 6 12